+++++++++++
+         
+ + ++ + ++
+++ +  +  +
+$  +++  ++
++++++++  +
+ O +  + ++
+++ ++++  +
+ +    ++ +
+    +    +
+++++++++ +
