+++++++++++
+  ######~
+ +#++ +#++
+++#+  +#~+
+###+++ #++
++++++++#~+
+ O#+  +#++
+++#++++##+
+~+####++#+
+~~##+####+
+++++++++ +

