+++++++++++
+         +
          +
+++ +  +  +
+$  +++  ++
++++++++  +
+   +  + ++
+++ ++++  +
+ +    ++ +
+    +    +
++        +
